NO ./images/hell/floor.xpm
SO ./images/hell/wall1.xpm
WE ./images/hell/wall2.xpm
EA ./images/hell/wall3_1.xpm

C 0, 0, 0
F 255, 86, 2

11111111111111111111111111111
10111111011111011101101111111
1N00000011111011101101100111
10000000000000000000000000001
10000000000000000000000000001
10000000000111111111000000001
10000000000000000000000000001
10011111111110000000000000001
10000000000000000000000000001
10000000000000000001100000001
10001111111111000000000000001
10000000000000000000000000001
10000000000000000000000000001
10000000011111111111100000001
10000000000000000000000000001
10000000000000000000000000001
10000001111111111000000000001
10000000000000000000000000001
10000000000000000000000000001
10000000000000011111111111001
10001111111100000000000000001
10000000000000000000000000001
11111111111111111111111111111